F W F A F . . . . .
. . . F . . . . . .
. . W F F . . . . .
A F F . . . . . . .
F F A F W F . . . .
</>
. 2 . 1 . . . . . .
. . . . . . . . . .
. . 1 . . . . . . .
1 . . . . . . . . .
. . 1 . 3 . . . . .
</>
0 0 0 0 0 0 0 0 0 0
0 0 0 0 0 0 0 0 0 0
0 > 1 < 0 0 0 0 0 0
0 0 0 0 0 0 0 0 0 0
0 0 0 0 0 0 0 0 0 0